C 225,30,0
NO ./textures/north.xpm
SO ./textures/south.xpm
EA ./textures/east.xpm
F 255,100,0
WE     ./textures/west.xpm

111111
100001111
10N000001
100000111
1011101 
111 111