NO ./path_to_the_north_texture
SO ./path_to_the_south_texture
WE ./path_to_the_west_texture
EA ./path_to_the_east_texture
F 11,22,22
C 11,11,11

11111111111
1CF100C00C1
10000111001
1P0011E0001
11111111111