NO ./path_to_the_north_texture

11111111111
1CF100C00C1
10000111001
1P0011E0001
11111111111